111111111111111
1001C00001100E1
1P0000010C00001
10000C011000001
111111111111111