111111111111111
11C0C000E110001
1C1000010C00011
10000C0110000P1
111111111111111