1111111
1PC1E11
10000C1
1111111